10 99
 ############
##          #
#           #
# $ $       #
#. @       .#
#############
